11 15
###############
#S....#.......#
#.###.#.#####.#
#...#.#.....#.#
###.#.###.#.#.#
#...#.....#.#.#
#.#######.#.#.#
#.......#.#...#
#.#####.#.###.#
#.....#.....#G#
###############
