####################
#S.................#
#..######..#######.#
#.............#....#
#.##########..#..#.#
#.#........#..#..#.#
#.#.######.#..#..#.#
#.#.#....#.#..#..#.#
#...#.##.#....#....#
###.#.##.######.####
#...#...............#
#..###########..##..#
#............#..##..#
#..########..#....G.#
####################
