####################
#S.................#
#..####....####....#
#..#..#....#..#....#
#..#..#....#..#....#
#..####....####....#
#..................#
#..####..######..###
#..#..#..#....#....#
#..#..#..#....#....#
#..####..#....#....#
#........#....#....#
###..######..##..#.#
#...............G..#
####################
