####################
#S..#..####..#.....#
##..#.....#..#.###.#
#...#####.#..#...#.#
#.###...#.#..###.#.#
#...#.#.#.#......#.#
###.#.#.#.########.#
#...#.#.#.....#....#
#.###.#.#####.#.####
#.....#.....#.#....#
#.#########.#.##.#.#
#.....#.....#..#.#.#
#.###.#.######.#.#.#
#...#...........#G.#
####################
