####################
#S..#.....#....#...#
##..#.###.#.##.#.###
#...#.#...#..#.#...#
#.###.#.#####.#.##.#
#.#...#.....#.#..#.#
#.#.#######.#.##.#.#
#.#.....#...#....#.#
#.#####.#.#######.##
#.....#.#.......#..#
###.#.#.#######.#..#
#...#.#.....#...#..#
#.###.#####.#.###..#
#.....#.....#....#G#
####################
