15 20
####################
#S.......#.........#
#.#####..#.#######.#
#.....#..#.......#.#
###.#.#..#######.#.#
#...#.#........#.#.#
#.###.########.#.#.#
#...#........#.#...#
#.#####.######.###.#
#.....#........#...#
#.###.########.#.###
#...#......#...#...#
###.######.#.#####.#
#.........#.......G#
####################
