####################
#S....#.......#....#
#.##..#.#####.#.##.#
#..#..#.....#.#..#.#
#..####.###.#.##.#.#
#.......#.#.#....#.#
#.#####.#.#.######.#
#.....#.#.#........#
###.#.#.#.##########
#...#.#.#.....#....#
#.###.#.#####.#.##.#
#.#...#.....#.#..#.#
#.#.#######.#.##.#.#
#.#.........#....#G#
####################
