####################
#S........#........#
#.######..#.######.#
#......#..#.#......#
#.####.#..#.#.######
#.#....#....#....#.#
#.#.###########.#..#
#.#.......#.....#..#
#.#######.#.#####.##
#.....#...#.....#..#
###.#.#.#######.#..#
#...#.#.....#...#..#
#.#.#.#####.#.###..#
#.#.........#....#G#
####################
